贵州遵义的高铁是在这边坐车吗	坐车
我从贵州遵义过来南站换乘在哪换乘	坐车
贵州遵义的高铁在哪上三楼	坐车
汕头的高铁是在这边坐车吗	坐车
我从汕头过来南站换乘在哪换乘	坐车
汕头的高铁在哪上三楼	坐车
要去哪里坐车	坐车
哎，帅哥问我这个，我去哪里坐车呢	坐车
都要到哪里去坐车找不到啊？第1次来	坐车
不好意思，我想问一下这是在哪坐车	坐车
是是我走错了找不着了写大名好，城轨也是在这坐车吧	坐车
他这个坐车从哪里上去啊	坐车
我去小榄那边，我到哪里去坐车啊	坐车
我这怎么坐车啊？这个	坐车
那我要怎么坐车啊	坐车
就是不知道怎么坐车啊	坐车
这是从哪里做坐车	坐车
唉，您好，我想问一下高铁往哪个方向	坐车
进站进高铁站去阳江都在哪边啊	坐车
从哪里上高铁	坐车
我想问一下去坐高铁从哪个进口进去的	坐车
虎门的高铁是在这边坐车吗	坐车
我从东莞过来转车该怎么上三楼	坐车
我从虎门过来南站换乘在哪换乘	坐车
虎门的高铁在哪上三楼	坐车
我买了票了，南站到汕头了，往那边走真的是走到头之后上3楼啊	坐车
问一下哪里上3楼	坐车
那你好，问一下这个是直接上3楼吗？在这里可以上吗	坐车
怎么上3楼去啊	坐车
3楼怎么上去	坐车
我买了票了，南站到汕头了，怎么上去上去3楼啊	坐车
问一下哪里能到3楼	坐车
那你好，问一下这个是能到3楼吗？在这里可以上吗	坐车
总之走到头之后就直接到3楼，直走到头是吗	坐车
怎么上去3楼	坐车
西出口的出发厅在什么位置	找西出发平台
我就说是有人来接我，他在出发厅等我	找出发平台
西出口的出发厅怎么上去	找西出发平台
东出口的出发厅怎么走	找东出发平台
东出口的出发厅在什么位置	找东出发平台
东出口出发厅在哪，有人在那接我	找东出发平台
东出发平台在哪个位置	找东出发平台
出发平台有人等我，怎么过去	找出发平台
出发平台等人，怎么走	找出发平台
出发平台进站是在几楼	找出发平台
就哪进站呢	坐车
进站进高铁站去阳江都在哪边啊	坐车
这个路那个进站口在哪里	坐车
哪里是进站口啊	坐车
那个进站口是在哪里啊	坐车
那进站口怎么进去啊	坐车
检票进站了	坐车
你好，请问一下这个从哪里进站的	坐车
请问一下那个我们要去候车室进站口往哪里走	坐车
如果进站的话是从正门进吗	坐车
进站地点在哪里	坐车
3层怎么上去	坐车
我买了票了，南站到汕头了，怎么上去3层啊	坐车
那我直接到3层啊，就出发了吗	坐车
问一下哪里能到3层	坐车
那你好，问一下这个是能到3层吗？在这里可以上吗	坐车
怎么上去3层	坐车
东出发平台怎么走	找东出发平台
西出发平台怎么走	找西出发平台
想问一下，4号桥是哪个出口	找到达口
珠海过来的高铁在哪个到达口	找到达口
中山过来的高铁在哪个到达口	找到达口
阳江过来的高铁在哪个到达口	找到达口
深圳过来的高铁在哪个到达口	找到达口
贵州遵义过来的高铁在哪个到达口	找到达口
5点到的轻轨在哪个到达口	找到达口
我想问一下那个衡阳过来的火车就是高铁，在哪里出来的	找到达口
所有的坐高铁都在这里吧，出站	找到达口
高铁1161是哪个口出啊	找到达口
请问在p2在哪边？p2停车场	找p2停车场
北停车场怎么走	找北1停车场
p1停车场在哪	找p1停车场
虎门过来的高铁在哪个到达口	找到达口
D7466班车的出站口在哪里	找到达口
查一下g407是在哪个出站口到达吗	找到达口
所有的坐高铁都在这里吧，出站	找到达口
我想问下那个柳州的高铁是哪个出站口出来的	找到达口
轻轨是在哪个到达口	找到达口
问一下南站北路在哪里走	找南站北路
你好，请问南站北路往哪一个方向	找南站北路
去南站北路要怎么走啊	找南站北路
南站北路怎么走最近，有人接	找南站北路
这边出去是什么门啊？是东广场吗	找东广场
东广场在哪个方向	找东广场
西广场怎么走	找西广场
出站口往哪里出了？	找出站口
都在这里出站吗，都在这个大厅出站	找出站口
请问到那个三元里大道往东哪个出站口近	找出站口
这边出去是什么门啊？是东门吗	找东门
这边出去是什么门啊？是西门吗	找西门
东出口怎么走	找东出口
东出口在哪个方向	找东出口
西出口怎么走	找西出口
西出口在哪个方向	找西出口
然后我我身份证忘带了，我只带了通行证跟驾驶证应该可以吧	人工窗口
为什么取票取不出来	人工窗口
去南宁取不出来票怎么办	人工窗口
为什么我身份证取不出来票	人工窗口
我想去取票，但是取不出来了	人工窗口
取不出来票去哪找柜台	人工窗口
我拿身份证那个小孩票取不出来怎么办	人工窗口
我想去那个上面，那个就是那个柜台上面买啊	人工窗口
我这个高铁票要改签去哪啊	找改签处
这个这个人工人工啊，人工售票了，人物售票	人工窗口
人工售票那边，那我还要去其他人的票呢	人工窗口
那个人工服务台售票在哪呢	人工窗口
人工服务台售票怎么走	人工窗口
得去人工那边，怎么找啊	人工窗口
人工售票这两边都有吗	人工窗口
唉，你好，我问一下那个人工售票住在什么地方	人工窗口
下午我改签这班车有问题是在这里做的对吧	找改签处
你好，我想请问一下在哪里改签	找改签处
在哪里改签	找改签处
我这个快开车了去哪能改签	找改签处
票买错了去哪改签	找改签处
东莞这趟车错过了去哪改签	找改签处
我这个证取不了高铁票啊	人工窗口
问一下用护照取票可以用设备取吗	人工窗口
港澳通行证可以用设备取票吗	人工窗口
回乡证取票可以用设备取吗	人工窗口
台湾通行证可以用设备取票吗	人工窗口
入台证取票可以用设备取吗	人工窗口
这里有吃的吗？	用餐
这里有吃的吗？就餐的	用餐
这边就餐有面条吗	用餐
这里有用餐的地方没	用餐
用餐的地方在哪	用餐
餐饮怎么走	用餐
肯德基在哪儿	找肯德基
肯德基怎么走	找肯德基
麦当劳在哪儿	找麦当劳
麦当劳怎么走	找麦当劳
72街在哪儿	找72街
72街怎么走	找72街
汤上功夫在哪儿	找汤上功夫
汤上功夫怎么走	找汤上功夫
哪里有吃汤粉的	找汤上功夫
有吃汤粉的地儿没	找汤上功夫
周黑鸭在哪儿	找周黑鸭
周黑鸭怎么走	找周黑鸭
优之选特产店在哪儿	找优之选
优之选特产店怎么走	找优之选
全家便利店在哪儿	找全家便利店
全家便利店怎么走	找全家便利店
便利店在哪儿	找便利店
便利店怎么走	找便利店
煌上煌在哪儿	找煌上煌
煌上煌怎么走	找煌上煌
快女面膜在哪儿	找快女面膜
快女面膜怎么走	找快女面膜
中山的轻轨能在这边买票吗	买票
那我买票要去哪买呀？我说的话前面就有	买票
之后是王小四那去那边买票啊	买票
啊，靓仔，我想问一下去哪买票啊	买票
我到贵州遵义，到哪里买票啊	买票
买票去上海	买票
到北站的车到那里去买票	买票
去哪里买票呢	买票
现在能买票吗	买票
在哪里买票	买票
在哪里买票上车	买票
轻轨在中山哪里买票	买票
买高铁票是在哪里买啊	买票
那我要订高铁票在哪里订的	买票
高铁站的售票大厅怎么走啊	买票
我是去东莞	坐大巴
东莞在哪坐车	坐大巴
你好，我想问一下坐大巴在哪	坐大巴
请问一下那个汽车站在哪里啊	坐大巴
你好，我想去顺德坐轻轨哦	坐城轨
到顺德的在哪坐车啊	坐城轨
那个顺德在哪个方向的啊	坐城轨
坐那个轻轨在哪坐啊	坐城轨
轻轨在中山哪里买票	坐城轨
轻轨去珠海在哪坐	坐城轨
去珠海轻轨在哪坐车	坐城轨
那个城轨的入口在哪里	坐城轨
城轨的那个候车室在哪里啊？去珠海的	坐城轨
到阳江的城轨在哪坐车？	坐城轨
去江门的城轨怎么走？	坐城轨
请问坐那个2号线在哪里坐啊	坐地铁
这是2号地铁站的入口，怎么走？他的那个f没有	坐地铁
2号地铁是这儿走吗	坐地铁
请问一下，2号那个地铁站在哪里	坐地铁
2号线地铁在哪	坐地铁
请问一下那个2号线地铁口怎么走	坐地铁
2号线是从哪儿坐	坐地铁
请问坐那个7号线在哪里坐啊	坐地铁
这是7号地铁站的入口，怎么走？他的那个f没有	坐地铁
7号地铁是这儿走吗	坐地铁
请问一下，7号那个地铁站在哪里	坐地铁
直走，就走到头，我要坐7号线去，我要坐那个7号	坐地铁
就是我要坐7号线	坐地铁
7号线地铁在哪	坐地铁
请问一下那个7号线地铁口怎么走	坐地铁
7号线是从哪儿坐	坐地铁
ATM机有吗	找ATM机
你好，这里有取款机吗	找ATM机
哪有充电的啊	借充电宝
你好，请问哪里有可以充电的地方啊	借充电宝
你好，问一下这里有没有充电宝这边	借充电宝
不好意思，我想问一下哪有充电宝啊，充电宝	借充电宝
我问一下哪里有充电宝	借充电宝
有没有充电的地方	借充电宝
充电宝在哪里借	借充电宝
问一下南站南路在哪里走	找南站南路
南站南路怎么走最近，有人接	找南站南路
南站南路在哪边啊	找南站南路
这里有失物招领处吗	找失物招领处
这里有星巴克吗	找星巴克
坐出租车的话怎么走	坐出租车
就坐公交车咋走啊？	坐公交
公交车站是在这边吗？	坐公交
你好，就是那个公交车站是在那边吗	坐公交
坐公交去哪坐呢	坐公交
你好，请问一下吧，我身份证弄丢了怎么去打身份证明呢？	办临时身份证
你好啊	打招呼
你几岁啦	打招呼
你工资多少啊	打招呼
你家在哪呀	打招呼
卫生间在哪	找卫生间
哪里有卫生间	找卫生间
洗手间在哪	找卫生间
哪里有洗手间	找卫生间
厕所在哪	找卫生间
哪里有厕所	找卫生间
在哪吃饭	用餐
哪里有饭吃	用餐
哪儿有饭吃	用餐
哪有饭吃	用餐
检票口在哪	坐车
检票口怎么走	坐车
去哪打车	打车
去哪打的	坐出租车
去哪坐的士	坐出租车
p1停车场在哪	找p1停车场
p1停车场怎么走	找p1停车场
p2停车场在哪	找p2停车场
p2停车场怎么走	找p2停车场
p3停车场在哪	找p3停车场
p3停车场怎么走	找p3停车场
p4停车场在哪	找p4停车场
p4停车场怎么走	找p4停车场
p5停车场在哪	找p5停车场
p5停车场怎么走	找p5停车场
p6停车场在哪	找p6停车场
p6停车场怎么走	找p6停车场
p7停车场在哪	找p7停车场
p7停车场怎么走	找p7停车场
p8停车场在哪	找p8停车场
p8停车场怎么走	找p8停车场
p10停车场在哪	找p10停车场
p10停车场怎么走	找p10停车场
母婴室在哪	找母婴室
母婴室怎么走	找母婴室
哪里有母婴室	找母婴室
哪有母婴室	找母婴室
哪里可以抽烟	找吸烟处
哪里能抽烟	找吸烟处
哪里有吸烟室	找吸烟处
吸烟室怎么走	找吸烟处
吸烟室在哪	找吸烟处
185服务台在哪	找185服务台
185服务台怎么走	找185服务台
580服务台在哪	找西门爱心驿站
580服务台怎么走	找西门爱心驿站
小件行李寄存处在哪	找行李寄存处
小件行李寄存处怎么走	找行李寄存处
行李寄存处在哪	找行李寄存处
行李寄存处怎么走	找行李寄存处
行李寄存在哪	找行李寄存处
行李寄存怎么走	找行李寄存处
问询处在哪	找问询处
问询处怎么走	找问询处
2号线L口在哪	找L口
2号线l口在哪	找L口
7号线K口在哪	找K口
7号线k口在哪	找K口
2号线J口在哪	找J口
2号线j口在哪	找J口
2号线B口在哪	找B口
2号线b口在哪	找B口
2号线D口在哪	找D口
2号线d口在哪	找D口
2号线F口在哪	找F口
2号线f口在哪	找F口
2号线H口在哪	找H口
7号线h口在哪	找H口
7号线C口在哪	找C口
7号线c口在哪	找C口
7号线E口在哪	找E口
7号线e口在哪	找E口
7号线G口在哪	找G口
7号线g口在哪	找G口
2号线L出口在哪	找L口
2号线l出口在哪	找L口
7号线K出口在哪	找K口
7号线k出口在哪	找K口
2号线J出口在哪	找J口
2号线j出口在哪	找J口
2号线B出口在哪	找B口
2号线b出口在哪	找B口
2号线D出口在哪	找D口
2号线d出口在哪	找D口
2号线F出口在哪	找F口
2号线f出口在哪	找F口
2号线H出口在哪	找H口
7号线h出口在哪	找H口
7号线C出口在哪	找C口
7号线c出口在哪	找C口
7号线E出口在哪	找E口
7号线e出口在哪	找E口
7号线G出口在哪	找G口
7号线g出口在哪	找G口
我这个票怎么退	人工窗口
我这个怎么退票	人工窗口
去哪退票	人工窗口
退票窗口在哪	人工窗口
中铁快运在哪里呀	找中铁快运
中铁快运在哪	找中铁快运
中铁快运怎么走	找中铁快运
高铁快递在哪边	找高铁快递
高铁快递怎么走	找高铁快递
辛苦你一下，帮我注册个12306	找处理12306账户
我这个12306账号登录不上啊	找处理12306账户
我12306密码忘记了是在这边处理吧	找处理12306账户
地铁7号线在哪里	坐地铁
去深圳怎么走	坐车
3楼候车室怎么上3楼	坐车
接客区怎么走	找p3停车场
p3停车场是沿那个p3指路牌走呢吧	找p3停车场
做高铁的去深圳从哪坐	坐车
我忘记带身份证了咋办	办临时身份证
p1停车场怎么过去	找p1停车场
想问一下这个到达的就是123楼都有是吧	找到达口
哪里可以办那个临时身份证	办临时身份证
去珠海的列车在哪里坐啊	坐城轨
2号线在哪里	坐地铁
那个公交车在往这边走吗？	坐公交
去阳江的是在哪	坐城轨
出发层是在3层吧	坐车
问一下进站口在哪	坐车
可是我是外国护照的	人工窗口
有一个东出发平台在哪里啊	找东出发平台
请问南在哪里	找南边
请问北在哪里	找北边
到哪里买票啊	买票
你好，p5怎么走	找p5停车场
北门在哪个哪一边哦	找北门
请问一下那个南出口在哪边	找南门
我想改车票怎么改签	找改签处
那我问一下在这里买的票，是不是在这里取呀	找自助取票机
你好，想问一下在哪里取票	找自助取票机
哪里是取票的	找自助取票机
我我想去取票，在哪里上去取票	找自助取票机
南宁的在哪里取票啊	找自助取票机
这边就是取票在哪里取啊	找自助取票机
在哪边取票啊	找自助取票机
中山坐轻轨过来怎么打印车票	找自助取票机
买好的高铁票在哪里取票	找自助取票机
我从珠海坐城轨过来怎么取票	找自助取票机
到哪里可以取票	找自助取票机
问一下那个取票口在哪	找自助取票机
取票的机子在哪里啊	找自助取票机
我重新取票再进站	找自助取票机
where is subway	坐地铁
how can I walk to the metro	坐地铁
where is coffee	找咖啡店